
16030000007700000000
00000500600660500000
00600005000050770000
00600006000500000300
00060007000003000030
00000003000003000000
00006050066600333000
00000000005050006060
00060055000333300000
00000600700000000000
00000000030000060070
00006660000050000000
00000006060000007007
00000000000070770027
