13000300030003000302
03030303030303030303
03030303030303030303
03030303030303030303
03030303030303030303
03030303030303030303
03030303030303030303
03030303030303030303
03030303030303030303
03030303030303030303
03030303030303030303
03030303030303030303
03030303030303030303
00030003000300030003
