
13000300030003000302
03030303030303030303
03030303030303030303
03030303030303030303
03030303030303030303
03030303030303030303
03030303030303030303
03030303030303030303
03030303030303030303
03030303030303030303
03030303030303030303
03030303030303030303
03030303030303030303
00030003000300030003

00000000000000000000
00000000000000001000
00000000000000300000
00000000000000300000
00000000000000300000
00000000000000300000
00000000000000300000
00000000000000300000
00000000000000300000
00000000000000300000
00000000000000300000
03333333333333300000
00000000000000300000
02000000000000300000
00000000000000000000

00000000033000000000
00000000033000000000
00000000033000000000
00000000033000000000
00000000033000000000
00000000033000000000
00000000033000000000
10000000033000000002
00000000033000000000
00000000033000000000
00000000033000000000
00000000033000000000
00000000033000000000
00000000033000000000
00000000033000000000
