
30000000000000000000
30000000000000333000
30000000000000000000
30000000000000000000
00000333000000000000
00000000003000000000
00000000888000000000
00100666666666600020
00000000777000000000
00000000000000000000
00000000000000000003
03333300000330000003
00000000000330000003
00000000000000000003
