
16030000007700000000
00000500600660500000
00600005000050770000
00600006000500000300
00060007000003000030
00000003000003000000
00006050066600333000
00000000005050006060
00060055000333300000
00000600700000000000
00000000030000060070
00006660000050000000
00000006060000007007
00000000000070770027

00000000000000000000
00000000000000000000
00000000000000020000
00000000000000000000
00000000333330000000
00000000000030000000
00000000000030000000
00001000000030000000
00000000000030000000
00000000000030000000
00000000333330000000
00000000000000000000
00000000000000000000
00000000000000000000

00000000000000000000
00000000000000000000
00000000000000000000
00033333333333333300
00030004444444400300
00030003333333300300
00030007777777700300
00031003333333302300
00030006666666600300
00030003333333300300
00030005555555500300
00033333333333333300
00000000000000000000
00000000000000000000
